201000000000000
101000000000000
101000000000000
101111111110000
100000000010000
111111111010000
000000001010000
000000001010000
000000001310000
000000001110000
000000000000000
000000000000000
000000000000000
000000000000000
000000000000000