000001111111111
011101010100011
011101010101011
011101010101011
011100000001000
311111011111110
110001010000110
111111011110110
100000000000110
001111111101110
011111111101110
010000001101110
011111101101112
011110000101111
000000111111100