111111111111000
100000000001000
101111110001000
001000011101000
011210000101000
010111110001000
010011311111100
011011000000100
011011111100100
011000000101100
011101111101000
000000000001000
111111111111000
000000000000000
000000000000000