0000000000010001
0111111111010101
0100000001010101
010000000101010
010000000101010
010000000101010
010000000101010
310000000101012
110000000101011
000000000101010
000000000101010
000000000101010
000000000101010
000000000100010
000000000111110
