110001000100001
000101010100101
011101010110101
010101010100101
010101010100101
210101010100101
010000010100101
010101010101101
010101001101101
010101001001101
010111000010101
010101110010101
010101010010101
011101010010131
000000010000111