100001000000001
000101000000001
000101000010001
000101000000001
000101000000001
200001010000001
000000010000001
000101010001101
000101000000001
000101000001001
000101000010001
000001000010001
000001000010001
000001000010031
000001010000001
