000001111111111
011101010100011
011101010101011
011101010101011
011100000001000
311111011111110
111111010000110
111111011110110
100000000000110
001111111101110
011111111101110
000000001101110
011111101101112
011110000001111
011110000001111
011110000001111